+--+--+--+--+
|    +      |
+--+ +--+ + +
|    |  | | |
+ +--+  + + +
| |     |   |
+ + +--+ +--+
|   |   |  g|
+--+--+--+--+
