+--+--+--+--+
|     |     |
+  +--+  +--+
|  |    |   |
+  +  +--+  +
|     |     |
+--+  +--+  +
|   |     g |
+--+--+--+--+
